00012000
22212222
20210202
20211202
20201202
20211202
20210202
20211202
20201202
20211202
20210202
20211202
20201202
20211202
22210222
00000000