00011000
00001000
11101111
00000001
11111111
00000001
00011111
10010000
10010000
11011111
00000001
00011111
00010000
00010000
00010000
00000000